NO ./textures/north.xpm
SO ./textures/south.xpm
WE ./textures/west.xpm



EA ./textures/east.xpm
F 255,250,205
C 175,238,238
        111111111111111111111111110
        100000000011000000000000001
        101100000111000000000000001
        100100000000000000100000001
11111111011000001110000000000000011
 E000000001100000111011111011111111
11110111111111011100000010001
11110111111111011101010010001
11000000110101011100000010001
10000000000000001100000010001
10000000000000001101010010001
11000001110101011111011110001
11110111 1110101 101111010001
11111111 1111111 111111111111
