NO ./textures/north_texture.xpm
SO ./textures/south_texture.xpm
WE ./textures/west_texture.xpm
EA ./textures/east_texture.xpm
F 220,100,0
C 225,30,0
1111111111
1N0S0E0W1
1 000000 1
1N000000W1
1111111111
