NO ./textures/north.xpm
SO ./textures/south.xpm
WE ./textures/west.xpm
EA ./textures/east.xpm
F 255,250,205
C 175,238,238
1111
11D1
11W1
1111
1111