NO ./textures/north.xpm
SO ./textures/south.xpm
WE ./textures/west.xpm
EA ./textures/east.xpm
F 255,250,205
C 175,238,238
11111
10 01
10101
10001
11111
