NO ./textures/north.xpm
SO ./textures/south.xpm
WE ./textures/east.xpm
EA ./textures/east.xpm
F 255,255,255
C 225,30,255


 1111111
10E000001
100000001 
100000001
 1111111
        