NO ./textures/north.xpm
SO ./textures/south.xpm
WE ./textures/west.xpm
EA ./textures/east.xpm
F 255,250,205
C 175,238,238
        1111111111111111111111111
        1000000000110000000000001
        1001000000000000000000001
        1011000001110000000000001
111111111011000001110000000000001
1001D1000011000001110111111111111
11110111111111011100000010001
1111D1D1111111011101010010001
11000000110101011100000010001
10000010000000001100000010001
10000000000000001101010010001
11000N01110101011111011110001
11110111 1110101 101111010001
11111111 1111111 111111111111